############
#...#......#
..#.#.####.#
###.#....#.#
#....###.#T.
####.#.#.#.#
#..#.#.#.#.#
##.#.#.#.#.#
#........#.#
######.###.#
#......#...#
############