####################
#...#........#.#...#
..#.#.####...#.#...#
###.#....#...#.....#
#....###.#.......#T.
####.#.#.#.#####...#
#..#.#.#.#.##......#
##.#.#.#.#......#..#
#........#....#.#.##
######.###...#.....#
#..................#
#......#....#......#
#......#....#......#
#......#....#......#
#......#....#......#
#......#....#......#
#......#....#......#
#......#....#......#
#......#....#......#
####################